dimension,determinant,pos_related_total,neg_related_total,unrelated_total,unk_direction_total,evidence_val,sig_name,sig_value,level_agreement
Demographic characteristics,Age,28,5,0,3,36,pos_related_total,28,77.77777777777779
Demographic characteristics,Citizenship,1,2,0,0,3,neg_related_total,2,66.66666666666666
Demographic characteristics,Ethnicity and race,44,11,0,3,58,pos_related_total,44,75.86206896551724
Demographic characteristics,Family structure,9,2,0,1,12,pos_related_total,9,75
Demographic characteristics,Gender,9,1,0,0,10,pos_related_total,9,90
Demographic characteristics,Group facilities,1,0,0,0,1,pos_related_total,1,100
Demographic characteristics,Language proficiency,8,2,0,0,10,pos_related_total,8,80
Demographic characteristics,Migration,5,3,0,0,8,pos_related_total,5,62.5
Demographic characteristics,Political inclination,1,1,0,0,2,pos_related_total,1,50
Demographic characteristics,Political inclination,1,1,0,0,2,neg_related_total,1,50
Demographic characteristics,Social dependence,5,0,0,0,5,pos_related_total,5,100
Demographic characteristics,Special needs/ disabilities,2,0,0,0,2,pos_related_total,2,100
Exposure,# Of events,3,0,0,0,3,pos_related_total,3,100
Exposure,Exposed areas / facilities,13,3,0,6,22,pos_related_total,13,59.09090909090909
Exposure,Exposed population,7,0,0,0,7,pos_related_total,7,100
Exposure,Hazard extent,11,2,0,0,13,pos_related_total,11,84.61538461538461
Exposure,Losses suffered,7,2,0,0,9,pos_related_total,7,77.77777777777779
Exposure,Mitigation,4,9,0,2,15,neg_related_total,9,60
Exposure,Other - physical considerations,24,11,0,8,43,pos_related_total,24,55.81395348837209
Exposure,Preparedness,2,3,0,0,5,neg_related_total,3,60
Health,Access,4,1,0,0,5,pos_related_total,4,80
Health,Caloric intake/ food insecurity,0,1,0,0,1,neg_related_total,1,100
Health,Disease burden / morbidity,2,1,0,0,3,pos_related_total,2,66.66666666666666
Health,Life expectancy,0,1,0,0,1,neg_related_total,1,100
Health,Mortality,1,0,0,0,1,pos_related_total,1,100
Health,Potable water access,2,2,1,0,5,pos_related_total,2,40
Health,Potable water access,2,2,1,0,5,neg_related_total,2,40
Health,Sanitation,1,0,0,0,1,pos_related_total,1,100
Land tenure,Owners,5,1,0,3,9,pos_related_total,5,55.55555555555556
Land tenure,Private property,0,0,0,1,1,unk_direction_total,1,100
Land tenure,Renters,7,5,0,0,12,pos_related_total,7,58.333333333333336
Land tenure,Tenure length,2,1,0,0,3,pos_related_total,2,66.66666666666666
Living conditions,Housing quality,2,0,0,0,2,pos_related_total,2,100
Living conditions,Housing type,2,0,0,0,2,pos_related_total,2,100
Living conditions,Land use,8,4,0,1,13,pos_related_total,8,61.53846153846154
Living conditions,Lifelines & infrastructure,8,2,0,3,13,pos_related_total,8,61.53846153846154
Living conditions,Population,13,2,0,4,19,pos_related_total,13,68.42105263157895
Living conditions,Resource dependence,9,1,0,1,11,pos_related_total,9,81.81818181818183
Living conditions,Rurality,3,5,0,0,8,neg_related_total,5,62.5
Living conditions,Socially isolated populations,1,0,0,0,1,pos_related_total,1,100
Living conditions,Urbanization,4,3,0,0,7,pos_related_total,4,57.14285714285714
Living conditions,Vacant housing units,3,0,0,0,3,pos_related_total,3,100
Living conditions,Vehicular access,6,0,0,1,7,pos_related_total,6,85.71428571428571
Risk perception,Awareness,4,3,0,1,8,pos_related_total,4,50
Risk perception,Prior experience,6,3,0,0,9,pos_related_total,6,66.66666666666666
Risk perception,Risk denial/ acceptance,3,3,0,0,6,pos_related_total,3,50
Risk perception,Risk denial/ acceptance,3,3,0,0,6,neg_related_total,3,50
Risk perception,Social capital,1,4,0,0,5,neg_related_total,4,80
Risk perception,Trust in officials,1,1,0,2,4,unk_direction_total,2,50
Socioeconomic status,Access to basic needs,1,0,0,0,1,pos_related_total,1,100
Socioeconomic status,Education,15,6,0,0,21,pos_related_total,15,71.42857142857143
Socioeconomic status,Employment,8,1,0,0,9,pos_related_total,8,88.88888888888889
Socioeconomic status,House value,1,4,0,0,5,neg_related_total,4,80
Socioeconomic status,Income,14,18,0,1,33,neg_related_total,18,54.54545454545454
Socioeconomic status,Literacy,0,2,0,0,2,neg_related_total,2,100
Socioeconomic status,Median rent,1,4,0,0,5,neg_related_total,4,80
Socioeconomic status,Occupation,7,1,0,1,9,pos_related_total,7,77.77777777777779
Socioeconomic status,Wealth,17,1,0,0,18,pos_related_total,17,94.44444444444444
